Ground Theme - Super Mario Bros. (Brawl)	a01_smb_chijyou
Underground Theme - Super Mario Bros.	a02_smb_chika
Underwater Theme - Super Mario Bros.	a03_smb_suichu
Underground Theme - Super Mario Land	a04_lnd_chika
Airship Theme - Super Mario Bros. 3	a05_smb3_hikousen
Castle / Boss Fortress - Super Mario World / SMB 3	a06_wld_castle_toride
Title/Ending - Super Mario World	a07_wld_title_ending
Main Theme - New Super Mario Bros.	a08_new_maintheme
Main Theme - Luigi's Mansion (Brawl)	a09_lm_theme
Gritzy Desert	a10_malrpg2_zarazarasabaku
Delfino Plaza	a13_sms_dolpiktown
Ricco Harbor	a14_sms_riccoharbor
Main Theme - Super Mario 64	a15_sm64_maintheme
Mario Bros.	a17_mb_mariobrothers
Mario Circuit - Super Mario Kart	a20_smk_mariocircuit
Luigi Raceway - Mario Kart 64	a21_mk64_luigicircuit
Waluigi Pinball - Mario Kart DS	a22_mkds_waluigipinball
Rainbow Road - Mario Kart: Double Dash!!	a23_mkdd_rainbowroad
Ground Theme / Underground Theme - Super Mario Bros.	a24_smb_chijyou_chika
Super Mario Bros. 3 Medley	a25_smb3_medley
Athletic Theme - New Super Mario Bros. 2	a26_new2_athletic_chijyou
Ground Theme / Underwater Theme - Super Mario 3D Land	a27_3dl_smb_theme	a27a_3dl_smb_theme_part1	a27b_3dl_smb_theme_part2
Try, Try Again	a28_malrpg4_tryandtry
Paper Mario Medley	a29_ppm_medley	a29a_ppm_medley_part1	a29b_ppm_medley_part2	a29c_ppm_medley_part3
Rainbow Road Medley	a30_mkt_rainbowroad_medley
Rainbow Road - Mario Kart 7	a31_mkt7_rainbowroad
Super Mario Bros. Medley	a32_smb_medley
Super Mario Bros.: The Lost Levels Medley	a33_smb2_medley
Fortress Boss - Super Mario World	a34_new2_touboss
Super Mario World Medley	a35_wld_medley
Circuit - Mario Kart 7	a36_mkt7_circuit
Cloudtop Cruise - Mario Kart 8	a37_mkt8_skygarden
Egg Planet	a38_glx_eggplanet
Rosalina in the Observatory / Luma's Theme	a39_glx_tenmondainorosetta
Chill (for 3DS / Wii U)	a40_drm_chill_ver2
Mario Paint Medley	a41_mpt_medley
Luigi's Mansion Series Medley	a42_lm_medley
Ground Theme - New Super Mario Bros. 2	a44_new2_chijyou
Ground Theme - New Super Mario Bros. U	a45_newu_chijyou
Ground Theme - Super Mario series	a45a_newu_chijyou_smmlink
Pandemonium	a47_pty9_minigame
Tough Guy Alert!	a48_malrpg3_choitotsuyoiyatsura
The Grand Finale	a49_malrpg3_inthefinal
Mushroom Gorge - Mario Kart Wii	a50_mktw_kinokocanyon
Mario Kart Stadium - Mario Kart 8	a51_mkt8_mariokartstadium
Mario Circuit - Mario Kart 8	a52_mkt8_mariocircuit
Rainbow Road - Mario Kart 8	a53_mkt8_rainbowroad
Egg Planet	a54_glx_eggplanet
Gusty Garden Galaxy	a55_glx_windgarden
Super Mario Galaxy	a56_glx_supermariogalaxy
Sky Station	a57_glx2_sorajima
Bowser's Galaxy Generator	a58_glx2_shingingateikoku
Fated Battle	a59_glx2_shukumeinokessen
Theme of SMG2	a60_glx2_themeofsmg2
On the Hunt -Gloomy Manor Ver.- (Instrumental)	a62_lm2_urameshiyashiki
Super Bell Hill	a63_3dw_field01
The Great Tower Showdown 2	a64_3dw_finkoopa02
Champion Road	a65_3dw_milkyway
Ground Theme - Super Mario series	a66a_smb3_chijyou_smmlink
Slide	a67_sm64_slider
Ground Theme - Super Mario Bros. 2	a68_musa_chijyou	a74_musa_chijyou_hurryup
Main Theme - Super Mario 64	a69_sm64_maintheme
Title Theme - Super Mario Maker	a70_smm_title
Ground Theme - Super Mario Bros.	a71_smb_chijyou	a73_smb_chijyou_hurryup
Ground Theme - Super Mario series	a71a_smb_chijyou_smmlink
Ground Theme - Super Mario World	a72_wld_chijyou
Ground Theme - Super Mario series	a72a_wld_chijyou_smmlink
Boss Theme - Super Mario Bros. 2	a74_musa_chijyou_hurryup
Break Free (Lead the Way)	a75_smo_breakfree
Underground Moon Caverns	a76_smo_finaldungeon
Steam Gardens	a77_smo_forestkingdom
Jump Up, Super Star!	a78_smo_jumpupsuperstar
Jump Up, Super Star! (Full Band Performance)	a78_smo_jumpupsuperstar_full
Jump Up, Super Star!	a78_smo_jumpupsuperstar	a78a_smo_jumpupsuperstar_partlink_dr	a78a_smo_jumpupsuperstar_partlink_ba	a78a_smo_jumpupsuperstar_partlink_gt	a78a_smo_jumpupsuperstar_partlink_tp	a78a_smo_jumpupsuperstar_partlink_vo
New Donk City	a79_smo_newdonkcity
Ground Theme (Band Performance) - Super Mario Bros.	a80_smo_smbtheme_bandplay
Ground Theme (Full Band Performance) - Super Mario Bros.	a80_smo_smbtheme_bandplay_full
Ground Theme (Band Performance) - Super Mario Bros.	a80_smo_smbtheme_bandplay	a80a_smo_smbtheme_bandplay_partlink_dr	a80a_smo_smbtheme_bandplay_partlink_ba	a80a_smo_smbtheme_bandplay_partlink_gt	a80a_smo_smbtheme_bandplay_partlink_tp
Fossil Falls	a81_smo_waterfallkingdom
Main Theme - Luigi's Mansion	a82_lm_theme
Delfino Plaza	a83_sms_dolpiktown
King Bowser - Super Mario Bros. 3	a84_smb3_maoukuppa
Ground Theme - Super Mario Bros. 3	a85_smb3_chijyou
Fortress Boss - Super Mario Bros. 3	a86_smb3_toridenoboss
The Starship Sails	a87_glx2_hoshibunehayuku
Melty Monster	a88_glx2_magmamonster
Battle! - Paper Mario: Color Splash	a90_pmc_battle
Stadium Theme - Mario Tennis: Ultra Smash	a91_tnsus_simpletennis
World Tour	a97_gfw_worldtornament
Title Theme - Mario Party: Island Tour	a98_ptyis_maintheme
Rocket Road	a99_ptyis_boardbgm2
Title Theme - Mario vs. Donkey Kong: Tipping Stars	aa04_mvdmin_title
Rolling Hills A	aa05_mvdmin_rollinghills
Time's Running Out!	aa06_malpmm_isogebamaniau
Mixed-Up Scramble	aa07_malpmm_toriodedaikonsen
Attack and Run!	aa08_malpmm_attackendrun
Kingdom Stadium: Night	aa14_sptss_kingdumstadium_yoru
Country Field: away team	aa15_sptss_countryfield_senkou
This is Minion Turf!	aa16_malr1d_koregabokosukabattle
Excitebike - Mario Kart 8	aa17_mkt8d_excitebike
Dragon Driftway	aa18_mkt8d_dragonroad
Ice Ice Outpost	aa19_mkt8d_tsurutsurutwister
The King of Pyropuff Peak	aa20_skt_dragonboss
Plucky Pass Beginnings	aa21_skt_kinopiotaicho_theme
Ground Theme - Super Mario Bros. 2	aa22_musa_chijyou
Title Theme - Mario Tennis Aces	aa23_tnsac_mariotennistheme
Stadium Theme - Mario Tennis Aces	aa24_tnsac_stadiumtheme
Starker / Wicked Child	ad01_fc_starker
Out of Time	ad03_fc_outoftime
Bloody Tears / Monster Dance	ad04_dc2_bloodytears
Dwelling of Doom	ad05_dc2_dwellingofdoom
Simon Belmont Theme	ad07_sfc_simonbelmontnotheme
Iron-Blue Intention	ad08_vk_ironblueintention
Awake	ad09_cm_awake
Lament of Innocence	ad10_cv_shinjitsunonageki
Jet Black Incursion	ad11_sj_shikkokunoshinkou
Jail of Jewel	ad12_gl_jailofjewel
Hail from the Past	ad13_gl_hailfromthepast
Divine Bloodlines	ad14_gl_keishou_kekkonnoketsuzoku
Vampire Killer	ad15_ju_vampirekiller
Mad Forest	ad17_ju_madforest
Dracula's Castle	ad18_ju_draculascastle
Dance of Illusions	ad19_ju_danceofillusions
Beginning	ad20_ac_beginning
Cross Your Heart	ad21_ac_jyujikawomuneni
Simon Belmont Theme (The Arcade)	ad22_ac_simonnotheme
Ruined Castle Gallery	ad23_hd_koujoukairou
Crash in the Dark Night	ad24_hd_yamiyonogekitotsu
Jet Black Wings	ad25_hd_shikkokunotsubasa
Ripped Silence	ad26_hd_kirisakaretaseijaku
Lost Painting	ad27_hd_ushinawaretasaiga
Nothing to Lose	ad28_hd_nothingtolose
The Tragic Prince	ad29_hd_hikyounokikoushi
Twilight Stigmata	ad30_hd_tasogarenoseikon
Can't Wait Until Night	ad31_hd_yorumadematenai
Aquarius	ad32_hd_aquarius
Slash	ad33_hd_slash
Go! Getsu Fuma	ad35_hd_ikegetsufuma
Dance of Gold	ad36_gy_ougonnobukyoku
Black Night	ad37_ac_blacknight_lasstboss2
Vampire Killer	ad38_ju_vampirekiller
Jungle Level (Brawl)	b01_spr_junglelevel_ver2
The Map Page / Bonus Level	b02_spr_mappage_bonuslevel
Opening - Donkey Kong	b03_dk_opening
Donkey Kong	b04_dk_donkeykong
King K. Rool / Ship Deck 2	b05_spr_kingkrool_shipdeck2
Stickerbush Symphony	b06_spr2_togetogetarumeiro
Battle for Storm Hill	b07_jbt_arashigaokanotatakai
25m Theme	b09_dk_25mbgm
Gear Getaway	b11_rtn_thrillgearflight
Jungle Level Jazz Style (for 3DS / Wii U)	b12_spr_junglelevel
Donkey Kong Country Returns (Vocals)	b13_rtn_donkeykongreturnes_cv
Donkey Kong Country Returns	b14_rtn_donkeykongreturnes
Jungle Hijinxs	b15_rtn_bananajungle
Mole Patrol	b16_rtn_mogryanokoujigenba
Mangrove Cove	b17_tfr_mangroves
Swinger Flinger	b18_tfr_theme03
Jungle Level Tribal Style (for 3DS / Wii U)	b19_spr_junglelevel_ethnic
Donkey Kong / Donkey Kong Jr. Medley	b20_dk_medley
Crocodile Cacophony	b21_spr2_crocodilecacophony
The Map Page / Bonus Level	b22_spr_mappage_bonuslevel
Snakey Chantey	b23_spr_shipdeck2
Gang-Plank Galleon	b24_spr_thepirateship
Funky's Fugue	b25_spr_funkykongpage
Ice Cave Chant	b26_spr_theicecove
Boss 2 - DK: Jungle Climber	b27_jcl_btlcommon
One Of A Kind	by01_by_oneofakind
Riders Of The Light	by02_by_ridersofthelight
Theme Of Bayonetta - Mysterious Destiny (Instrumental)	by03_by_mysteriousdestiny
Let's Hit The Climax!	by04_by_letshittheclimax
Red & Black	by05_by_redandblack
After Burner (∞ Climax Mix)	by06_by_afterburnerclimaxmix
Friendship	by07_by_tomoyo
Let's Dance, Boys!	by08_by_letsdanceboys
The Legend Of Aesir	by09_by2_thelegendofaesir
Tomorrow Is Mine (Bayonetta 2 Theme) (Instrumental)	by10_by2_tomorrowismine
Time For The Climax!	by11_by2_timefortheclimax
Title Theme - The Legend of Zelda	c01_zld_title
Overworld Theme - The Legend of Zelda (Brawl)	c02_zld_maintheme
Great Temple / Temple	c03_lnk_daishinden_shinden
Dark World (Brawl)	c04_tri_yaminosekai
Hidden Mountain & Forest	c05_tri_uranoyamatomori
Tal Tal Heights	c07_yms_tarutarukougen
Hyrule Field Theme	c08_tno_hyrulemaintheme
Ocarina of Time Medley	c09_tno_medley
Song of Storms	c10_tno_arashinouta
Village of the Blue Maiden	c12_4sw_aonomikonomura
Termina Field	c14_mnk_terminaheigen
Dragon Roost Island	c15_kzt_ryuunoshima
Main Theme - The Legend of Zelda: Twilight Princess	c17_tpr_maintheme
The Hidden Village	c18_tpr_wasureraretasato
Overworld & Underworld - The Legend of Zelda (for 3DS / Wii U)	c20_zld_maintheme_chika
Dark World (for 3DS / Wii U)	c21_tri_uranochijyou_uradungeon
Gerudo Valley	c22_tno_gerudonotani
Full Steam Ahead	c23_dnk_trainfield2
Ballad of the Goddess	c24_sws_megaminouta_ghirahim
Saria's Song / Middle Boss Battle	c25_tno_sarianouta
The Great Sea / Menu Select	c26_kzt_oounabara_menuselect
Gerudo Valley	c28_tno_gerudonotani
Ballad of the Goddess	c29_sws_megaminouta
Hyrule Main Theme	c30_tri2_hyrulemaintheme
Lorule Main Theme	c31_tri2_lorulemaintheme
Yuga Battle (Hyrule Castle)	c32_tri2_yuganotheme
Overworld Theme - The Legend of Zelda	c33_zld_chijiyou
Overworld Theme - The Legend of Zelda: A Link to the Past	c34_tri_omotenochijiyou
Hyrule Field Theme	c35_tno_hyrulemaintheme
The Legend of Zelda Medley	c36_zld_medley
Calamity Ganon Battle - Second Form	c37_bow_ganon_latter
Hyrule Castle (Outside)	c38_bow_hyrulejyou_outside
Kass's Theme	c39_bow_kasstheme
Main Theme - The Legend of Zelda: Breath of the Wild	c40_bow_maintheme
Nintendo Switch Presentation 2017 Trailer BGM	c41_zds_3rdtrailertheme
Midna's Lament	c42_tpr_kizudarakenomidna
Main Theme - The Legend of Zelda: Tri Force Heroes	c43_tri3_maintheme
Molgera	c44_kzt_morudogeira
Death Mountain	c45_zld_deathmountain
Termina Field	c46_mnk_terminaheigen
Woodlands - The Legend of Zelda: Tri Force Heroes	c47_tri3_moriarea
Saria's Theme	c48_tno_sarianouta
Menu - Super Smash Bros. for 3DS / Wii U	crs01_menu
Battlefield - Super Smash Bros. for 3DS / Wii U	crs02_senjyou
Final Destination - Super Smash Bros. for 3DS / Wii U	crs03_shuuten
Multi-Man Smash	crs04_kumite
Master Hand - Super Smash Bros. for 3DS / Wii U	crs05_masterhand
Master Core	crs06_mastercore
Online Practice Stage - Super Smash Bros. for 3DS / Wii U	crs07_online
Classic: Results Screen	crs11_simple_result
Classic: Final Results	crs12_simple_result_final
Classic: Fail	crs13_simple_result_failure
All-Star Rest Area - Super Smash Bros. for 3DS / Wii U	crs15_rest
Gallery/Hoard	crs18_figuremeikan
Trophy Shop	crs19_figureshop
Lifelight (JP)	crs2_00a_maintheme_jp
Lifelight	crs2_00b_maintheme_en
Menu	crs2_01_menu
Battlefield	crs2_02_senjyou
Final Destination	crs2_03_shuuten
Mob Smash	crs2_04_kumite
Master Hand	crs2_05_masterhand
Tourney: Battle List	crs2_07_vs_table
Tourney: Winner Announcement	crs2_08_vs_victory
Training	crs2_11_trainingstage
The Light Realm: Prologue	crs2_12_adv_map_light
The Light Realm: Base	crs2_13_adv_map_light_subcommon
The Dark Realm	crs2_14_adv_map_dark
The Final Battle	crs2_15_adv_map_final
Classic Mode: Bonus Stage	crs2_16_bonusstage
Galeem	crs2_17_vs_kiila1
Dharkon	crs2_19_vs_darz1
Galeem/Dharkon	crs2_21_vs_kiila_darz
Free the Spirit!	crs2_22_spiritsboard_roulette
Spirits: Collection	crs2_23_edit_common
Spirits: Inventory/Items	crs2_27_spirits_organize
Classic Mode: Mural	crs2_28_classic_dificulty
Classic Mode: Defeat	crs2_31_classic_result_failure
Classic Mode: Final Results	crs2_33_classic_result_final
Practice Fights	crs2_36_simulationstage
Spectate	crs2_38_online_watching
Vault	crs2_40_collection
Shop	crs2_41_shop
Crazy Hand	crs2_42_crazyhand
Master Hand / Crazy Hand	crs2_43_masterhand_crazyhand
The Dark Realm: The Mysterious Space	crs2_45_adv_map_dark_subcommon
The Final Battle: After the Transformation	crs2_46_adv_map_final_later
Main Theme Piano Solo	crs2_47_maintheme_piano
The Light Realm: March	crs2_48_adv_map_light_later
Trophy Rush	crs20_figurerush
Replay/Album/Records	crs21_album
StreetSmash	crs22_surechigaidairantou
How to Play - Super Smash Bros. Melee	crs23_asobikata
Results Screen - Super Smash Bros. for 3DS / Wii U	crs24_vs_result
Credits - Super Smash Bros. for 3DS / Wii U	crs25_staffroll
Final Destination Ver. 2	crs26_shuuten_ver2
Master Fortress: First Wave	crs27_masterfortress01
Master Fortress: Second Wave	crs28_masterfortress02
Smash Tour: Map	crs31_world_map
Events	crs36_tournament_table
Master Orders: Ticket Selection	crs39_order_masterside
Brinstar (Brawl)	d01_mr_maintheme
Norfair	d02_mr_norfair
Ending - Metroid	d03_mr_ending
Vs. Ridley (Brawl)	d04_smr_vsridley
Theme of Samus Aran, Space Warrior	d05_smr_samusarannotheme
Sector 1	d06_fsn_sector1
Opening/Menu - Metroid Prime	d07_prm_opnening_menu
Vs. Meta Ridley	d09_prm_vsmetaridley
Multiplayer - Metroid Prime 2: Echoes	d10_prm2_multiplay
Title Theme - Metroid	d11_mr_title
Escape	d12_mr_dasshutu
Psycho Bits	d13_pht_psychobits
The Burning Lava Fish	d14_otm_yougangyobattle
Lockdown Battle Theme	d15_otm_hanyoutojikomebattle
Nemesis Ridley	d16_otm_ridleybattle
Vs. Parasite Queen	d17_prm_vsparasitequeen
Vs. Ridley	d18_smr_vsridley
Brinstar Depths	d19_mr_brinstarshinbu
Main Theme - Metroid Prime: Federation Force	d20_pff_splashscreen
End Results - Metroid: Samus Returns	d21_srt_result
Magmoor Caverns - Metroid: Samus Returns	d22_srt_areabgmnettai
Boss Battle 4 - Metroid: Samus Returns	d23_srt_zetametroid
Yoshi's Tale	e01_str_ending
Obstacle Course - Yoshi's Island	e02_ild_athletic
Obstacle Course - Yoshi's Island	e02a_ild_athletic_spring_summer
Obstacle Course - Yoshi's Island	e02b_ild_athletic_autumn_winter
Obstacle Course - Yoshi's Island	e02_ild_athletic	e02a_ild_athletic_spring_summer	e02b_ild_athletic_autumn_winter
Yoshi's Island (Brawl)	e03_ild_yoshiisland
Flower Field	e05_cty_ohanabatake
Wildlands	e06_ilds_kouyanotheme
Yoshi's Island (for 3DS / Wii U)	e07_ild_stage1_1
Main Theme - Yoshi's Woolly World	e08_kny_keitonoyoshi
Main Theme - Yoshi's New Island	e09_nild_maintheme
Bandit Valley	e10_nild_gypsy
Main Theme - Yoshi's Woolly World	e11_wol_yoshiwoolworld
Main Theme - Yoshi's New Island	e12_nild_maintheme
The Legendary Air Ride Machine	f01_air_airridemachine
King Dedede's Theme (Brawl)	f02_kby_dededeounotheme
Boss Theme Medley - Kirby Series	f03_kby_bossthememedley
Butter Building (Brawl)	f04_yim_butterbuilding
Gourmet Race (Brawl)	f05_sdx_gekitotsugourmetrace
Meta Knight's Revenge	f06_sdx_metaknightnogyakushuu
Vs. Marx	f07_sdx_vsmarx
02 Battle	f08_kby64_zerotwosen
Frozen Hillside	f11_air_colda
Squeak Squad Theme	f12_sdd_dorochedannotheme
Green Greens (for 3DS / Wii U)	f13_kby_greengreens_ver2
Green Greens	f14_kby_gb_greengreens
Kirby Retro Medley	f14a_kby_gb_greengreens_scenelink
Castle Lololo	f15_kby_gb_castlelololo
Float Islands	f16_kby_gb_floatislands
Butter Building (for 3DS / Wii U)	f19_yim_butterbuilding
King Dedede's Theme (for 3DS / Wii U)	f20_sdx_dedededaiounotheme
The Great Cave Offensive	f21_sdx_doukutsudaisakusen
Forest/Nature Area	f22_knd_morishizenarea
Celestial Valley	f23_air_vallerion
The Adventure Begins	f24_kbyw_boukennohajimari
Through the Forest	f25_kbyw_moriwonukete
Floral Fields	f26_tdx_fuyuutairikunohanabatake
Forest Stage	f27_air_moristage
Planet Popstar	f28_kby64_popstar
The World to Win	f29_tdx_tamashiinotatakai
Ice Cream Island	f30_yim_icecreamisland
City Trial	f31_air_citytrial
Staff Credits - Kirby's Dream Land	f32_kby_staffroll
Sky Tower	f33_wii_skytower
Dangerous Dinner	f34_wii_dagerousdiner
CROWNED	f35_wii_crowned
Fatal Blooms in Moonlight	f36_tdx_kyoukasuigetsu
CROWNED: Ver.2	f37_ddz_crowned_ver2
Venturing Into the Mechanized World	f38_rbp_kikainosekainodaibouken
Pink Ball Activate!	f39_rbp_roboboarmor
Kirby Battle Royale: Main Theme	f40_bdx_maintheme
A Battle of Friends and Bonds 2	f41_sta_tomotokizunanotatakai2
Kirby Retro Medley	f42_kby_gb_medley
Kirby Retro Medley	f42_kby_gb_medley	f14a_kby_gb_greengreens_scenelink	f15_kby_gb_castlelololo	f16_kby_gb_floatislands	f17_kby_gb_bubblyclouds	f18_kby_gb_mtdedede
Let the Battles Begin!	ff01_ff7_tatakaumonotachi
Fight On!	ff02_ff7_saranitatakaumonotachi
Main Theme - Star Fox	g01_sfx_maintheme
Corneria - Star Fox	g02_sfx_corneria
Main Theme - Star Fox 64 (Brawl)	g03_sfx64_maintheme
Area 6 - Star Fox 64	g04_sfx64_area6
Star Wolf (Brawl)	g05_sfx64_starwolf
Space Battleground	g07_ast_sentoutyuuiki
Break: Through the Ice	g08_ast_hyougentoppaseyo
Star Wolf	g09_ast_starwolf
Space Armada	g10_sfx_spacearmada
Area 6 Ver. 2 - Star Fox 64	g11_sfx64_area6ver2
Star Wolf's Theme / Sector Z (for 3DS / Wii U)	g12_sfx64_starwolf_sectorz
Theme from Area 6 / Missile Slipstream	g13_sfx64_cmd_area6_missle
Return to Corneria - Star Fox Zero	g14_sfz_stgcorneria2
Corneria - Star Fox Zero	g15_sfz_stgdefence
Sector Ω	g16_sfz_stgspace4
Main Theme - Pokémon Red & Pokémon Blue (Brawl)	h01_pm_maintheme
Pokémon Center - Pokémon Red / Pokémon Blue	h02_pm_pokemoncenter
Road to Viridian City - Pokémon Red / Pokémon Blue	h03_pm_tokiwahenomichi_nibicity
Pokémon Gym/Evolution - Pokémon Red / Pokémon Blue	h04_pm_pokemongym_shinka
Battle! (Wild Pokémon) - Pokémon Ruby / Pokémon Sapphire	h05_rs_sentou_yaseipokemon
Victory Road - Pokémon Ruby / Pokémon Sapphire	h06_rs_championroad
Battle! (Wild Pokémon) - Pokémon Diamond / Pokémon Pearl	h07_dp_sentou_yaseipokemon
Battle! (Dialga/Palkia) / Spear Pillar	h08_dp_dialgapalkia_yarinohashira
Battle! (Team Galactic)	h09_dp_gingadan
Route 209 - Pokémon Diamond / Pokémon Pearl	h10_dp_209bandouro
N's Castle	h11_bw_n_medley
Battle! (Reshiram/Zekrom)	h12_bw_sentou_zekrom_reshiram
Battle! (Trainer Battle) - Pokémon X / Pokémon Y	h13_xy_sentou_trainer
Lumiose City	h14_xy_miarecity
Battle! (Champion) / Champion Cynthia	h16_dp_sentou_champion
Route 10 - Pokémon Black / Pokémon White	h17_bw_10bandouro
Route 23 - Pokémon Black 2 / Pokémon White 2	h18_b2w2_23bandouro
Battle! (Team Flare)	h19_xy_vs_flare
Battle! (Wild Pokémon) - Pokémon X / Pokémon Y	h20_xy_sentou_yaseipokemon
Victory Road - Pokémon X / Pokémon Y	h21_xy_championroad
Battle! (Champion) - Pokémon X / Pokémon Y	h22_xy_sentou_champion
Battle! (Wild Pokémon) - Pokémon Sun / Pokémon Moon	h23_sm_sentou_yaseipokemon
Battle! (Steven)	h24_oras_kessen_daigo
Battle! (Island Kahuna)	h25_sm_sentou_shimakingshimaqueen
Battle! (Gladion)	h26_sm_sentou_gladion
Battle! (Elite Four) / Battle! (Solgaleo/Lunala)	h27_sm_sentou_shitennou_solgaleo_lunala
Battle! (Trainer) - Pokémon Sun / Pokémon Moon	h28_sm_sentou_trainer
Battle! (Lorekeeper Zinnia)	h29_oras_sentou_higana
The Battle at the Summit!	h30_sm_choujoukessen
Mute City (Brawl)	i01_fzr_mutecity
White Land	i02_fzr_whiteland
Fire Field	i03_fzr_firefield
Car Select	i04_fzx_carselect
Dream Chaser	i05_fzx_dreamchaser
Devil's Call in Your Heart	i06_fzx_devilscallinyourheart
Climb Up! And Get the Last Chance!	i07_fzx_climbup_andgetthelastchance
Brain Cleaner	i08_gx_braincleaner
Shotgun Kiss	i09_gx_shotgunkiss
Planet Colors	i10_gx_planetcolors
Mute City (for 3DS / Wii U)	i11_fzr_mutecity
Mute City	i12_fzr_sfc_mutecity
Red Canyon	i14_fzr_redcanyon
F-ZERO Medley	i15_fzr_medley
Sand Ocean	i16_fzr_sandocean
Big Blue	i17_fzr_bigblue
Death Wind	i18_fzr_deathwind
Fire Field	i19_fzr_firefield
Port Town	i20_fzr_porttown
Sand Ocean	i21_fzr_sandocean
Silence	i22_fzr_sandocean
White Land	i23_fzr_whiteland1
White Land II	i24_fzr_whiteland2
Big Blue	i25_fzr_bigblue
Fire Emblem Theme	j02_fem_theme
Shadow Dragon Medley	j03_fem_aankokuryuumedley
With Mila's Divine Protection (Celica Map 1)	j04_gdn_miranokagototomoni
Preparing to Advance	j06_snk_shingekijunbi
Winning Road - Roy's Hope	j07_fnk_winningroad_roynokibou
Attack - Fire Emblem	j08_rnk_kougeki
Against the Dark Knight	j09_sek_againstthedarkknight
Crimean Army Sortie	j10_sek_crimeaarmysortie
Power-Hungry Fool	j11_sek_powerhungryfool
Victory Is Near	j12_sek_victoryisnear
Eternal Bond	j13_anm_ikenotheme
Id (Purpose)	j14_ksi_i_i
Fight 1 - Fire Emblem Gaiden	j15_gdn_tatakai1
Meeting Theme Series Medley	j16_mnn_deainotheme
Fire Emblem: Mystery of the Emblem Medley	j17_mnn_singeki
Coliseum Series Medley	j18_ssk_tougijyou
The Devoted	j20_anm_tyuugitsukusan
Time of Action	j21_anm_kekkinotoki
Duty (Ablaze)	j22_ksi_shimei_honoo
Conquest (Ablaze)	j23_ksi_ensei_honoo
Lost in Thoughts All Alone (for 3DS / Wii U)	j24_if_hitoriomou
Lost in Thoughts All Alone (JP)	j25_if_hitoriomou
Lost in Thoughts All Alone	j26_if_lostinthoughtsallalone
Gear Up For...	j27_hr_menu
Lost in Thoughts All Alone	j28_if_hitoriomou
Prelude (Ablaze)	j29_ksi_jomaku_honoo
Edge of Adversity	j30_ssk_shituinohate
Destiny (Ablaze)	j31_ksi_shukumei_honoo
Those Who Challenge Gods	j32_eco_btl_a2
The Scions' Dance in Purgatory	j33_eco_btl_berkut2
March to Deliverance	j34_eco_mapb_a2
Lord of a Dead Empire	j35_eco_mapb_rudlf
Under This Banner	j36_mnn_konohatanomotoni
Advance	j37_mnn_singeki
Beyond Distant Skies - Roy's Departure	j38_fnk_anosoranomukouni_roynotabidachi
Id (Purpose)	j39_ksi_i_i
Fire Emblem Theme (Heroic Origins)	j40_hr_menutitle
Snowman	k01_mtr_snowman
Humoresque of a Little Dog	k05_mtr_humoresqueofalittledog
Porky's Theme	k07_mtr_porkynotheme
Mother 3 Love Theme	k08_mtr3_ainotheme
Unfounded Revenge / Smashing Song of Praise	k09_mtr3_revenge_bukkowashisanka
You Call This a Utopia?!	k10_mtr3_utopiadesho
Magicant (for 3DS / Wii U)	k11_mtr_magicant_eightmelodies
Smiles and Tears	k12_mtr2_smileandtears
Onett Theme / Winters Theme	k13_mtr2_onettnotheme
Magicant	k14_mtr_magicant
Fourside	k15_mtr2_fourside
World Map - Pikmin 2	l01_pik2_worldmap
Forest of Hope	l02_pik_kibounomori
Environmental Noises	l03_pik_kankyouon
Main Theme - Pikmin	l06_pik_maintheme
Stage Clear / Title Theme - Pikmin	l07_pik_clear_title
Stage Select - Pikmin 2	l09_pik2_stageselect
Mission Mode - Pikmin 3	l10_pik3_missionmode
Garden of Hope	l11_pik3_saikainohanazono
Garden of Hope	l12_pik3_saikainohanazono
Over Wintry Mountains	l13_hpk_tokusyucourse4omote
The Keeper of the Lake	l14_hpk_boss2
Flashes of Fear	l15_hpk_boss4
Fragment of Hope	l16_hpk_boss9later
Main Theme - Pikmin	l17_pik_maintheme
WarioWare, Inc.	m01_miw_madeinwario	m09_miw_game_yokero	m10_miw_game_fumareruna	m11_miw_game_kawase	m12_miw_game_nureruna	m13_miw_game_tobe	m15_miw_game_narase	m16_miw_game_kudake	m17_miw_game_ugokuna	m18_miw_game_appeal
WarioWare, Inc.	m01_miw_madeinwario	m09_miw_game_yokero	m10_miw_game_fumareruna	m11_miw_game_kawase	m12_miw_game_nureruna	m13_miw_game_tobe	m15_miw_game_narase	m16_miw_game_kudake	m17_miw_game_ugokuna	m18_miw_game_appeal
WarioWare, Inc. Medley	m02_miw_medley
Mona Pizza's Song (JP)	m03_mmw_kochiramonapizza
Mona Pizza's Song	m04_mmw_monapizzassong
Mike's Song (JP)	m05_smw_mikegasukisuki
Mike's Song	m06_smw_mikessong
Ashley's Song (JP) (Brawl)	m07_smw_ashreynotheme
Ashley's Song	m08_smw_ashreyssong
Ashley's Song (JP) (for 3DS / Wii U)	m19_smw_ashreynotheme
Ruins - Wario Land: Shake It!	m20_wls_1_1_1_iseki
Gamer	m21a_gaw_gamer_normal
Gamer	m21b_gaw_gamer_mom
Gamer	m21b_gaw_gamer_mom
Encounter	mg02_mgs_encounter
Theme of Tara	mg03_mg_themeoftara
Yell ""Dead Cell""	mg04_mgs2_yelldeadcell
Snake Eater (Instrumental)	mg05_mgs3_snakeeater_instrumental
MGS4 ～Theme of Love～	mg06_mgs4_themeoflove
Cavern	mg07_mgs_cavern
Battle in the Base	mg08_mgs3_battleinthebase
Calling to the Night	mg11_callingtothenight
Snake Eater	mg12_mgs3_snakeeater
Theme of Solid Snake	mg13_mg2_themeofsolidsnake
Main Theme - METAL GEAR SOLID PEACE WALKER	mg14_msp_maintheme
Roar/Rathalos	mh01_mhxx_houkou
Proof of a Hero ～ 4Version	mh02_mh4_eiyuunoakashi
Title Theme - Animal Crossing: Wild World (Brawl)	n01_dnm_title
Go K.K. Rider!	n02_dnm_yuke_kekerider
2:00 a.m. - Animal Crossing: Wild World	n03_dnm_200am
The Roost - Animal Crossing: Wild World	n05_oid_junkissa_hatonosu
Town Hall and Tom Nook's Store - Animal Crossing: Wild World	n06_oid_yakubatotanukichi
K.K. Cruisin'	n07_dnm_kk_urban	n08_dnm_kk_western	n09_dnm_kk_neworleans	n10_dnm_kk_rocknroll	n11_dnm_kk_eurobeat	n12_dnm_kk_perunouta
K.K. Western	n08_dnm_kk_western
K.K. Gumbo	n09_dnm_kk_neworleans
Rockin' K.K.	n10_dnm_kk_rocknroll
DJ K.K.	n11_dnm_kk_eurobeat
K.K. Condor	n12_dnm_kk_perunouta
Tortimer Island Medley	n13_tbd_kotobukiland_medley
Kapp'n's Song	n14_tbd_kappeinouta
Plaza / Title Theme - Animal Crossing: City Folk / Animal Crossing: Wild World	n15_mhi_town_main
Outdoors at 7 p.m. (Sunny) / Main Street - Animal Crossing: New Leaf	n16_tbd_feild19ji_hare
Tour - Animal Crossing: New Leaf	n17_tbd_tour
Bubblegum K.K.	n18_tbd_kekeidol
Title Theme - Animal Crossing: Happy Home Designer	n19_hhd_title
Title Theme - Animal Crossing: Wild World	n20_dnm_title
Title Theme - Animal Crossing	n21_dmp_title
House Preview	n24_hhd_kanseidemo
Underworld	p01_pnk_meifukai
Title Theme - Kid Icarus	p02_pnk_title
Overworld	p03_pnk_chijyoukai
Kid Icarus Retro Medley	p04_pnk_genkyokumedley
Wrath of the Reset Bomb	p05_shs_syokikabakudannokyoufu
In the Space-Pirate Ship	p06_shs_seizokusen
Boss Fight 1 - Kid Icarus: Uprising	p07_shs_bosssen1
Dark Pit's Theme	p09_shs_blackpitnotheme
Lightning Chariot Base	p11_shs_ginganoseiiki
Destroyed Skyworld	p12_shs_houkaiengeland
Magnus's Theme	p13_shs_magnanotheme
Hades's Infernal Theme	p15_shs_hadesnotheme
Thunder Cloud Temple	p16_shs_raiunnoteien
Famicom Medley	q01_fc_famicommedley
Stack-Up/Gyromite	q02_rob_blockandgyro
Chill (Brawl)	q04_drm_chill
Clu Clu Land	q05_clu_clucluland
Balloon Trip (Brawl)	q06_bft_balloontrip
Ice Climber (Brawl)	q07_ice_iceclimber
Shin Onigashima Medley	q08_oni_shinonigashima
Title Theme - 3D Hot Rally	q09_3hr_title
Tetris: Type A	q10_trs_typea
Tetris: Type B	q11_trs_typeb
Tunnel Scene - X	q12_x_tunnelscene
Power-Up Music - Wrecking Crew	q13_wcr_powerup
Douchuumen - The Mysterious Murasame Castle	q14_nmj_douchu
Balloon Fight Medley	q15_bft_medley
Balloon Trip (for 3DS / Wii U)	q16_bft_balloontrip
The Mysterious Murasame Castle Medley	q17_nmj_medley
Jogging / Countdown	q18_po_running_countdown
Duck Hunt Medley (for 3DS / Wii U)	q19_dkh_title
Wrecking Crew Medley (for 3DS / Wii U)	q20_wcr_gamestart
Minor Circuit	q21_mpo_shiaityuu
Light Plane (for 3DS / Wii U)	q22_pw_lightplane
Light Plane (Vocal Mix) (for 3DS / Wii U)	q23_pw_lightplane_ver2
Wrecking Crew Retro Medley	q24_wcr_bgma
Light Plane	q26_pw_lightplane
Light Plane	q27_pw_lightplane
Duck Hunt Medley	q28_dkh_medley
Wrecking Crew Medley	q29_wcr_bgmb
Yūyūki Medley	q30_yyk_medley
PictoChat	r02_pictochat
Electroplankton	r03_electroplankton
Flat Zone 2	r04_gw_flatzone2
Mario Tennis / Mario Golf	r05_mtg_mariotennis_mariogolf
Lip's Theme - Panel de Pon	r06_pdp_lipnotheme
Marionation Gear	r07_mmg_marionationgear
Title Theme - Big Brain Academy	r08_yaj_title
Golden Forest	r09_1080_goldenforest
Mii Channel	r10_ngc_nigaoechannel
Wii Shop Channel	r11_spc_wiishopingchannel
Battle Scene / Final Boss - Golden Sun	r12_ont_sentou_boss
Personal Trainer: Cooking	r13_onv_shaberuoryourinavi
Excite Truck	r14_ext_excitetruck
Brain Age: Train Your Brain in Minutes a Day!	r15_nou_dstraning
Charge! - Wii Play	r17_hwi_ushidash
Bathtime Theme (for 3DS / Wii U)	r18_ntd_shower
Bathtime Theme (Vocal Mix) (for 3DS / Wii U)	r19_ntd_shower_ver2
Mii Plaza	r20_ngc_nigaoehiroba
Minor Circuit	r21_wpo_minorcircuit
Afternoon on the Island (for 3DS / Wii U)	r22_tdcs_tomodachicollection
Gaur Plain	r23_xbd_gaurheigen
You Will Know Our Names	r24_xbd_nawokansurumonotachi
Mechanical Rhythm	r25_xbd_kinoritsudou
Save the World, Heroes!	r26_scd2_sekaiwosukueyuushayo
Dark Lord	r27_scd2_yaminoou
Super Hoop	r28_wft_hoopdance
Wii Fit Plus Medley	r29_wftp_athleticmii
Skateboard Arena (Free Mode)	r30_wftp_skebo_freemode
Wii Sports Series Medley	r31_wsp_title
Wii Sports Resort	r32_wsr_title
Wii Sports Resort Ver. 2	r33_wsr_title_ver2
The Valedictory Elegy	r34_bt2_thevaledictoryelegy
Glory of Heracles	r35_hne_battleareaa_greecce
Xenoblade Chronicles Medley	r36_xbd_arrangemedley
Boss 1 - Sakura Samurai: Art of the Sword	r37_hsz_boss1
Freakyforms: Your Creations, Alive! Medley	r38_iki_maintheme
Turbo Jet	r39_pwr_hikouki
Pedal Glider	r40_pwr_hangglider
Culdcept	r41_cct_opening
Nintendo Land Medley	r42_nld_title
Style Savvy: Trendsetters	r43_wgf_title
Rhythm Boxing	r44_wft_rhythmboxing
Mischievous Mole-way	r45_wftp_segwaychallange_tyuukyuu
Core Luge	r46_wftu_luge
Final Results - Wii Party U	r47_wptu_theme_1
Title Theme - Wii Sports Resort	r48_wsr_title
Menu - Brain Age 2: More Training in Minutes a Day!	r49_motto_menu
Attack - Soma Bringer	r50_sbg_bosskyuumonsterbattle
Tomorrow's Passion	r51_cap_macnouta
PERFORMANCE	r52_bbdx_performance
Title Theme - Punch-Out!! (Wii)	r53_po_splashscreen
World Circuit Theme	r54_po_worldcircuitfight
Engage the Enemy	r55_xbd_tekitonotaiji
Time to Fight! - Xenoblade Chronicles	r56_xbd_sentou
Gaur Plain (Night)	r57_xbd_gaurheigen_yoru
An Obstacle in Our Path - Xenoblade Chronicles	r58_xbd_yukutewohabamumono
Tunnel Theme - X-Scape	r59_xrt_tunnelnormal
Weyard	r60_ont_worldmap
Swan Lesson	r61_egk_swan_lesson
Dragon Battle	r63_arg_dragonnotatakai
Title Theme - Nintendo Land	r64_nld_title
Pop Fashion Show	r65_wgf_fashonshow
Dillon's Rolling Western: The Last Ranger	r66_rlw_move2
Title Theme - NES Remix 2	r67_rmx_remix2_title
ST01: Roll Out, Wonderful 100!	r68_101_rolloutwonderful100
Jergingha - Planet Destruction Form	r69_101_jerginghaplanetdestructionform
Blue Birds	r70_rtg_bluebirds
Monkey Watch	r71_mrt_sarudokei
Wii Shop Channel	r72_spc_wiishopingchannel
Training Menu - Wii Fit U	r73_wftu_trainingmenu
Title Theme - Wii Sports Club	r74_wsc_maintitle
Electroplankton	r75_electroplankton
Find Mii / Find Mii II Medley	r76_scd_seriesmedley
Trouble Brewing II	r77_stm_hotspot2
Bathtime Theme	r78_ntd_shower
Noisy Notebook	r79_snp_w1stage
Afternoon on the Island	r80_tdcs_tomodachicollection
Title Theme - Wii Sports	r81_wsp_openingtheme
Main Menu - Wii Fit	r82_wft_mainmenu
Advanced Step	r83_wft_fumidaidance
Yoga	r84_wft_yoga
Fruit Basket	r85_rtb_fruitsbasket
Tennis (Training)	r87_wsc_tnstraining
Baseball (Training)	r88_wcs_bsbtraining
Filled with Hope	r89_std_kibouwomuneni
Title Theme - Nintendo Badge Arcade	r90_btc_title_maintheme
Arcade Bunny's Theme	r91_btc_baitotheme
Battle Start - Fossil Fighters: Frontier	r92_khm_battlekaishi
Welcome Center	r94_hpl_mapfirst
Code Name: F.E.	r95_stm_sodename_fe
Lords-A Chance Encounter	r96_stm_lords_kaikou
Lords-Showdown	r97_stm_lords_kessen
Revolt -Striving for Hope-	r98_ccr_revolt_kibouhenokekki
Worthy Rival Battle	r99_ccr_koutekishubattle
Boss Battle	rr02_mtp_eventsentou
Boss: The Darkest Lord	rr05_mtp_chomaousen_hontai
Garage	rr06_ttp_garage
Dawn in the Desert	rr07_eoa_fieldmain
Struggle Against Chaos	rr08_eoa_battle2later
Battle!! - Xenoblade Chronicles 2	rr09_xbd2_sentou
Still, Move Forward!	rr10_xbd2_soredemomaeesusume
Those Who Stand Against Our Path - Xenoblade Chronicles 2	rr11_xbd2_yukutewohabamumonotachi
Ring a Ding	rr12_gm4_ringdongdang
Frontier Battle	rr13_dhb_kaitakuchinotatakai
Mega Man 2 Medley	s01_rm2_medley
Air Man Stage	s02_rm2_airman_stage
Spark Man Stage	s03_rm3_sparkman_stage
Mega Man 2 Retro Medley	s04_rm2_originalmedley
Cut Man Stage	s05_rm_cutman_stage
Quick Man Stage	s06_rm2_quickman_stage
Shadow Man Stage	s07_rm3_shadowman_stage
Mega Man Retro Medley	s08_rm_originalmedley
Mega Man 3 Retro Medley	s09_rm3_originalmedley
Mega Man 4-6 Retro Medley	s10_rm4_6_originalmedley
Wood Man Stage	s11_rm2_woodmanstage
Dark Man Stage	s12_rm5_darkmanstage
Top Man Stage	s13_rm3_topmanstage
Ice Man Stage	s14_rm_icemanstage
Bomb Man Stage	s15_rm_bombmanstage
Fire Man Stage	s16_rm_firemanstage
Metal Man Stage	s17_rm2_metalmanstage
Crash Man Stage	s18_rm2_crashmanstage
Mega Man 4 Medley	s19_rm4_medley
Gravity Man Stage	s20_rm5_gravitymanstage
Napalm Man Stage	s21_rm5_napalmmanstage
We're Robots (Dr. Wily Stage 2)	s22_rm9_weretherobots_wilystage2
Opening Stage	s23_rmx_openingstage
Guts Man Stage	s24_rm_gutsmanstage
Hard Man Stage	s25_rm3_hardmanstage
Flash In The Dark (Dr. Wily Stage 1)	s26_rm9_flashinthedark_wilystage1
X vs ZERO	s27_rmx5_xvszero
Zero (Theme of ZERO (from Mega Man X))	s28_rrz_themeofzero_fromx
Shooting Star	s29_rrm_shootingstar
Snake Man Stage	s30_rm3_snakemanstage
Flash Man Stage	s31_rm2_flashmanstage
Ryu Stage Type A	sf01a_sf2_ryu	sf01b_sf2_ryu_pinch
Ryu Stage Type B	sf02a_sf2_ryu_2	sf02b_sf2_ryu_2_pinch
Ken Stage Type A	sf03a_sf2_ken	sf03b_sf2_ken_pinch
Ken Stage Type B	sf04a_sf2_ken_2	sf04b_sf2_ken_2_pinch
Ken Stage Type B	sf04b_sf2_ken_2_pinch
Ryu Stage	sf05_sf2_ryustage
Ken Stage	sf06_sf2_kenstage
Guile Stage	sf07_sf2_guilestage
Vega Stage	sf08_sf2_balrogstage
Blanka Stage Type A	sf09a_sf2_blanka	sf09b_sf2_blanka_pinch
Blanka Stage Type B	sf10a_sf2_blanka_2	sf10b_sf2_blanka_2_pinch
Guile Stage Type A	sf11a_sf2_guile	sf11b_sf2_guile_pinch
Guile Stage Type B	sf12a_sf2_guile_2	sf12b_sf2_guile_2_pinch
Chun-Li Stage Type A	sf13a_sf2_chunli	sf13b_sf2_chunli_pinch
Chun-Li Stage Type B	sf14a_sf2_chunli_2	sf14b_sf2_chunli_2_pinch
E. Honda Stage Type A	sf15a_sf2_ehonda	sf15b_sf2_ehonda_pinch
E. Honda Stage Type B	sf16a_sf2_ehonda_2	sf16b_sf2_ehonda_2_pinch
Zangief Stage Type A	sf17a_sf2_zangief	sf17b_sf2_zangief_pinch
Zangief Stage Type B	sf18a_sf2_zangief_2	sf18b_sf2_zangief_2_pinch
Dhalsim Stage Type A	sf19a_sf2_dhalsim	sf19b_sf2_dhalsim_pinch
Dhalsim Stage Type B	sf20a_sf2_dhalsim_2	sf20b_sf2_dhalsim_2_pinch
Balrog Stage Type A	sf21a_sf2_mbison	sf21b_sf2_mbison_pinch
Balrog Stage Type B	sf22a_sf2_mbison_2	sf22b_sf2_mbison_2_pinch
Vega Stage Type A	sf23a_sf2_balrog	sf23b_sf2_balrog_pinch
Vega Stage Type B	sf24a_sf2_balrog_2	sf24b_sf2_balrog_2_pinch
Sagat Stage Type A	sf25a_sf2_sagat	sf25b_sf2_sagat_pinch
Sagat Stage Type B	sf26a_sf2_sagat_2	sf26b_sf2_sagat_2_pinch
M. Bison Stage Type A	sf27a_sf2_vega	sf27b_sf2_vega_pinch
M. Bison Stage Type B	sf28a_sf2_vega_2	sf28b_sf2_vega_2_pinch
Dee Jay Stage Type A	sf29a_sf2_deejay	sf29b_sf2_deejay_pinch
Dee Jay Stage Type B	sf30a_sf2_deejay_2	sf30b_sf2_deejay_2_pinch
T. Hawk Stage Type A	sf31a_sf2_thawk	sf31b_sf2_thawk_pinch
T. Hawk Stage Type B	sf32a_sf2_thawk_2	sf32b_sf2_thawk_2_pinch
Fei Long Stage Type A	sf33a_sf2_feilong	sf33b_sf2_feilong_pinch
Fei Long Stage Type B	sf34a_sf2_feilong_2	sf34b_sf2_feilong_2_pinch
Cammy Stage Type A	sf35a_sf2_cammy	sf35b_sf2_cammy_pinch
Cammy Stage Type B	sf36a_sf2_cammy_2	sf36b_sf2_cammy_2_pinch
Player Select Type A	sf37a_sf2_playerselect
Player Select Type B	sf37b_sf2_playerselect
Splattack!	sp01_sp_splattack	sp06a_sp_nowornever_short
Ink or Sink	sp02_sp_inkorsink	sp06a_sp_nowornever_short
Kraken Up	sp04_sp_krakenup	sp06a_sp_nowornever_short
Metalopod	sp05_sp_metalopod	sp06a_sp_nowornever_short
Now or Never! - Splatoon	sp06_sp_nowornever
Ink Me Up	sp07_sp_kimiironisomete	sp08a_sp_imanuraneba_short
Now or Never! (Splatfest Version) - Splatoon	sp08_sp_imanuraneba
Calamari Inkantation	sp09_sp_shiokarabushi
Split & Splat	sp10_sp_quickstart
Octoweaponry	sp11_sp_octoweaponry
I Am Octavio	sp12_sp_iamoctavio
Now or Never!	sp14_sp_nowornever
Bomb Rush Blush	sp15_sp_tokimekibombrush
Seaskape	sp16_sp_seaskape
Splattack!	sp17_sp_splattack
Inkoming!	sp18_sp2_inkoming	sp27a_sp2_nowornever_short
Rip Entry	sp19_sp2_ripentry	sp27a_sp2_nowornever_short
Undertow	sp20_sp2_undertow	sp27a_sp2_nowornever_short
Don't Slip	sp21_sp2_dontslip	sp27a_sp2_nowornever_short
Endolphin Surge	sp22_sp2_endolphinsurge	sp27a_sp2_nowornever_short
Ebb & Flow	sp23_sp2_fullthrottle_tentacle	sp28a_sp2_imanuraneba_short
Acid Hues	sp24_sp2_ripplerefrain	sp28a_sp2_imanuraneba_short
Muck Warfare	sp25_sp2_redhotegoist	sp28a_sp2_imanuraneba_short
Deluge Dirge	sp26_sp2_gougou
Now or Never! - Splatoon 2	sp27_sp2_nowornever
Now or Never! (Splatfest Version) - Splatoon 2	sp28_sp2_imanuraneba
Credits - Super Smash Bros. (Brawl)	t01_sb_staffroll
Jungle Level (64)	t06_spr_kongojungle
Credits - Super Smash Bros. (for 3DS / Wii U)	t07_sb_staffroll
Yoshi's Story (64)	t08_sb_yoshiisland
Gourmet Race (64)	t09_sdx_pupupuland
Ground Theme - Super Mario Bros. (64)	t10_smb_peachjyoujoku
Overworld Theme - The Legend of Zelda (64)	t11_zld_hyrulejiyou
Brinstar (64)	t13_mr_wakuseizebes
Main Theme - Star Fox 64 (64)	t14_sfx64_sectorz
Main Theme - Pokémon Red & Pokémon Blue (64)	t15_pm_yamabukicity
How to Play - Super Smash Bros.	t17_sb_howtoplay
Menu - Super Smash Bros.	t18_sb_menu
Training Mode	t19_sb_trainingmode
Fighter Selection - Super Smash Bros.	t21_sb_characterselect
Meta Crystal	t22_sb_metacristal
Bonus Game - Super Smash Bros.	t23_sb_bonusgame
Duel Zone	t24_sb_duelzone
Final Destination - Super Smash Bros.	t25_sb_shuuten
Final Destination - Super Smash Bros.	t25a_sb_shuuten_introcut
Credits - Super Smash Bros.	t27_sb_ending_staffroll
Green Hill Zone	u01_snc_greenhillzone
Scrap Brain Zone	u02_snc_scrapbrainzone
Emerald Hill Zone	u03_snc2_emeraldhillzone
Angel Island Zone	u04_snc3_angelislandzone
Sonic Boom	u06_snccd_sonicboom
Super Sonic Racing	u07_sncr_supersonicracing
Open Your Heart	u08_sadv_openyourheart
Live & Learn	u09_sadv2_liveandlearn
Sonic Heroes	u10_shrs_sonicheroes
His World (Theme of Sonic The Hedgehog - 2006 E3 Version -)	u12_snc06_hisworld_instrumental
Seven Rings in Hand	u13_srng_sevenringsinhand
Escape from the City	u14_sadv2_escapefromthecity
Knight of the Wind	u15_sblk_knightofthewind
Reach for the Stars	u16_sclr_reachforthestars
Rooftop Run	u17_sgen_rooftoprun
Wonder World	u18_slst_wonderworld
Windy Hill - Zone 1	u19_slst_windyhill_zone1
Lights, Camera, Action! (Studiopolis Zone Act 1)	u20_smn_studiopolis_act1
Fist Bump	u21_sfo_fistbump
Sunset Heights	u22_sfo_sunsetheight
PAC-MAN	v01_pac_pacman
PAC-MAN (Club Mix)	v02_pac_pacman_clubmix
PAC-MAN'S PARK / BLOCK TOWN	v03_mna_pacmanspark_blocktown
Libble Rabble Retro Medley	v04_lbl_libblelabble_medley
Metro-Cross Retro Medley	v05_mcr_metrocross_medley
Namco Arcade '80s Retro Medley 1	v06_nmc_80smedley1
Namco Arcade '80s Retro Medley 2	v07_nmc_80smedley2
Sky Kid Retro Medley	v08_skd_skykid_medley
Galaga Medley	v11_glg_medley
Mappy Medley	v12_mpy_medley
Area 1 - Dragon Spirit	v13_dsp_area1
Ground Theme - Super Mario Bros. (Melee)	w01_smb_peachjyou
Slide	w02_sm64_rainbowcruise
Jungle Level (Melee)	w03_spr_junglegarden
Brinstar Depths (Melee)	w04_mr_brinstarshinbu
Athletic Theme - Super Mario World	w05_wld_yostertou
Gourmet Race (Melee)	w06_sdx_yumenoizumi
Green Greens (Melee)	w07_kby_greengreens
Star Fox Medley	w08_sfx_cornelia
Main Theme - Pokémon Red & Pokémon Blue (Melee)	w09_pm_pokemonstadium
Pokémon Red / Pokémon Blue Medley	w10_pm_pokemonakuukan
Big Blue (Melee)	w11_fzr_bigblue
Bein' Friends	w12_mtr_onet
Ice Climber (Melee)	w13_ice_iciclemountain
Flat Zone	w14_gw_flatzone
Ground Theme - Super Mario Bros. 3 (Melee)	w15_smb3_supermario3
Pokémon Gold / Pokémon Silver Medley	w16_kg_pekemonstadiumkingin
Story 5 Meeting	w17_fem_fireemblem
Mach Rider	w18_mrd_machrider
Pollyanna (I Believe in You)	w19_mtr_pollyanna
Fever	w20_drm_drmario
Battlefield - Super Smash Bros. Melee	w21_sbdx_senjyou
Multi-Man Melee	w23_sbdx_hyakuninkumite
Temple Theme	w24_lnk_shinden
Final Destination - Super Smash Bros. Melee	w25_sbdx_shuuten
DK Rap	w26_dk64_monkyrap
Brinstar (Melee)	w27_mr_brinstar
Main Theme - Star Fox 64 (Melee)	w28_sfx_wakuseivenom
Mute City (Melee)	w29_fzr_mutecity
Menu - Super Smash Bros. Melee	w30_sbdx_menu
Giga Bowser	w31_sbdx_gigakoopa
Fourside (Melee)	w32_mtr2_fourside
Menu 2 - Super Smash Bros. Melee	w33_sbdx_menu2
Menu - Super Smash Bros. Melee (Brawl)	w34_sbdx_menu
Battlefield - Super Smash Bros. Melee (for 3DS / Wii U)	w35_sbdx_menu_ver2
Overworld Theme - The Legend of Zelda (Melee)	w36_zld_greatbay
Yoshi's Story (Melee)	w37_str_yoshistory
Multi-Man Melee 2	w39_sbdx_hyakuninkumite2
Metal Battle	w40_sbdx_metalbattle
Trophies	w41_sbdx_figuremeikan
All-Star Intro	w42_sbdx_rest
Opening - Super Smash Bros. Melee	w43_sbdx_opening
Targets!	w44_sbdx_targetwokowase
Tournament	w45_sbdx_tornament1
Tournament 2	w46_sbdx_tornament2
How to Play - Super Smash Bros. Melee	w48_sbdx_asobikata
Opening - Super Smash Bros. Melee (Brawl)	w49_sbdx_opening
Main Theme - Super Smash Bros. Brawl	x01_sbx_maintheme
Menu - Super Smash Bros. Brawl	x02_sbx_menu1
Battlefield - Super Smash Bros. Brawl	x04_sbx_senjyou
Final Destination - Super Smash Bros. Brawl	x05_sbx_shuuten
Online Practice Stage - Super Smash Bros. Brawl	x07_sbx_onlinerenshuustage
Tournament Registration	x09_sbx_tornament_entry
Tournament Grid	x10_sbx_tornament_table
Tournament Match End	x11_sbx_tornament_finish
All-Star Rest Area - Super Smash Bros. Brawl	x15_sbx_rest
Home-Run Contest	x16_sbx_homeruncontest
Cruel Smash	x17_sbx_nasakemuyoukumite
Boss Battle - Super Smash Bros. Brawl	x18_sbx_bossbattle
Trophy Gallery	x19_sbx_figuremeikan
Sticker Album / Album / Chronicle	x20_sealmeikan
Coin Launcher	x21_coinshooter
Stage Builder	x23_stageedit
Battlefield Ver. 2 - Super Smash Bros. Brawl	x25_sbx_senjyou_ver2
Target Smash!	x26_sbx_targetwokowase
Credits - Super Smash Bros. Brawl	x27_sbx_staffroll
Adventure Map	y01_sbx_adv_map
Step: The Plain	y02_sbx_step_heichi
Step: Subspace	y04_sbx_step_akuukan
Boss Battle Song 1	y05_sbx_bosssentoukyoku1
Boss Battle Song 2	y07_sbx_bosssentoukyoku2
Step: Subspace Ver. 3	y15_sbx_step_akuukan_ver3
Ground Theme - Super Mario series	z84_j_orekyoku_smm_chijyou_link	a71a_smb_chijyou_smmlink	a66a_smb3_chijyou_smmlink	a72a_wld_chijyou_smmlink	a45a_newu_chijyou_smmlink
Mass Destruction	ps01_p3_mass_destruction
Battle Hymn of the Soul	ps02_p3_subetenohitono_tamashiinotatakai
Reach Out To The Truth	ps03_p4_reachout_to_thetruth
I'll Face Myself	ps04_p4_illface_myself
Time To Make History	ps05_p4_timeto_makehistory
Wake Up, Get Up, Get Out There	ps06_p5_wakeup_getup_getoutthere
Last Surprise	ps07_p5_lastsurprise
Rivers In the Desert	ps08_p5_riversin_thedesert
Our Beginning	ps09_p5_ourbeginning
Aria of the Soul	ps10_p5_subetenohitono_tamashiinouta
Beneath the Mask	ps11_p5_beneath_themask
Unflinchable Courage	dq01_dq11_hirumanuyuuki
The Hero Goes Forth with a Determination 	dq02_dq11_yuushahayuku
Fighting Spirits - DRAGON QUEST III	dq03_dq3_sentounotheme
Adventure - DRAGON QUEST III	dq04_dq3_boukennotabi
Battle for the Glory - DRAGON QUEST IV	dq05_dq4_sentou
Wagon Wheel's March	dq06_dq4_bashanomarch
War Cry	dq07_dq8_otakebiwoagete
Marching through the Fields	dq08_dq8_daiheigennomarch
Spiral Mountain	bk01_bk_kurukuruyamanofumoto
Main Theme - Banjo-Kazooie	bk02_bk_title
Mumbo's Mountain	bk03_bk_mumbomountain
Treasure Trove Cove	bk04_bk_otakarazakuzakubeach
Freezeezy Peak	bk05_bk_frozunzunyama
Gobi's Valley	bk06_bk_gobivalleysabaku
Mad Monster Mansion	bk07_bk_madnightmansion
Vs. Klungo	bk08_bk2_vsklungo
Vs. Mr. Patch	bk09_bk2_vsmrpatch
Vs. Lord Woo Fak Fak	bk10_bk2_vswoofakfakdaiou
MEGALOVANIA	rr14_ut_megalovania
Kurikinton - FATAL FURY 2	gd01_gd2_kurikinton
Kurikinton - FATAL FURY 2	gd02_gd2_kurikinton
Haremar Faith Capoeira School - Song of the Fight (Believers Will Be Saved) - FATAL FURY	gd03_gd_halemakyocapoereha_tatakainouta
The Sea Knows - FATAL FURY	gd04_gd_umihashitteiru
Pasta - FATAL FURY 2	gd05_gd2_pasta
A New Poem That the South Thailand Wants to Tell - FATAL FURY 2	gd06_gd2_thainanbunitsutaetai_atarashiiuta
Tarkun and Kitapy - FATAL FURY 2	gd07_gd2_takuntokitap
Let's Go to Seoul! - FATAL FURY 2	gd08_gd2_seoulniikou
The London March - FATAL FURY 2	gd09_gd2_londonmarch
The Working Matador - FATAL FURY 2	gd10_gd2_hatarakutougyushi
Duck Dub Dub (Duck, You Too) - FATAL FURY SPECIAL	gd11_gdsp_duckdubdub
Soy Sauce for Geese - FATAL FURY SPECIAL	gd12_gdsp_geesenishouyu
Art of Fighting Ver.230000000.0 - FATAL FURY SPECIAL	gd13_gdsp_ryukonoken_ver230000000
Big Shot! - FATAL FURY 3	gd14_gd3_bigshot
11th Street - FATAL FURY WILD AMBITION	gd16_gdwa_11thstreet
Ne! - KOF '94	gd17_kof94_ne
Stormy Saxophone 2 - KOF '96	gd18_kof96_arashinosaxophone
W.W.III - KOF XIV	gd20_kof99_ww3
176th Street - KOF '99	gd21_kof99_176thstreet
Terry115 - KOF 2000	gd22_kof00_terry115
Street Dancer - KOF XI	gd23_kofxi_streetdancer
ESAKA!! - KOF 2002 UM	gd24_kof02um_esaka
DESERT REQUIEM ~Operation02UM~ - KOF 2002 UM	gd25_kof02um_desertrequiem
KD-0079+ - KOF 2002 UM	gd26_kof02um_kd0079plus
Undercover - KOF 2002 UM	gd27_kof02um_undercover
Cutting Edge - KOF 2002 UM	gd28_kof02um_cuttingedge
The Second Joker - KOF XIII	gd29_kofxiii_thesecondjoker
Esaka Continues... - KOF XIII	gd30_kofxiii_esakacontinues
Wild Street - KOF XIII	gd31_kofxiii_wildstreet
Tame a Bad Boy - KOF XIII	gd32_kofxiii_tameabadboy
KDD-0063 - KOF XIII	gd33_kofxiii_kdd0063
Yappari ESAKA - KOF XIV	gd34_kofxiv_yappariesaka
Departure from South Town - KOF XIV	gd35_kofxiv_departure_from_southtown
Soy Sauce for Geese - KOF XIV	gd36_kofiv_geesenishouyu_xivver
IKARI - KOF XIV	gd37_kofxiv_ikari_xivver
New Order - KOF XIV	gd38_kofxiv_neworder_xivver
Theme of SYD - Alpha Mission	gd39_aso_themeofsyd
Forest World - Athena	gd40_atn_morinosekai
Psycho Soldier Theme	gd41_psy_psychosoldiertheme_jp
Psycho Soldier Theme (Overseas Version)	gd42_psy_psychosoldiertheme_en
ART of FIGHT - Art of Fighting	gd43_ryk_artoffight
Tuna - SAMURAI SHODOWN	gd44_ssp_maguro
Banquet of Nature - SAMURAI SHODOWN	gd45_ssp_shizennoutage
Gaia - SAMURAI SHODOWN	gd46_ssp_daichi
Kuri Kinton Flavor - KOF XIV	gd47_kofxiv_kurikintonfu
Main Theme from Metal Slug - METAL SLUG	gd48_mts1_maintheme
Assault Theme - METAL SLUG 1-3	gd49_mts1_3_assaulttheme
Judgment - METAL SLUG 2	gd50_mts2_judgment
Blue Water Fangs (The Island of Dr. Moreau) - METAL SLUG 3	gd51_mts3_soukainokiba
Final Attack - METAL SLUG 1-6	gd52_mts5_finalattack
Fire Emblem: Three Houses Main Theme (JP)	j41a_fsg_maintheme_jp
Fire Emblem: Three Houses Main Theme	j41b_fsg_maintheme_en
Fódlan Winds	j42_fsg_fodlanogyoufu
The Edge of Dawn (Seasons of Warfare) (JP)	j43a_fsg_hraesvelgrnoshoujo_fuukasetsugetsu
The Edge of Dawn (Seasons of Warfare)	j43b_fsg_theedgeofdawn_seasonsofwarfare
Tearing Through Heaven	j44_fsg_tensakuryuusei
Chasing Daybreak	j45_fsg_yabounochihei
Blue Skies and a Battle	j46_fsg_jujishitachinosoukyuu
Between Heaven and Earth	j47_fsg_tentochinokyoukai
The Apex of the World	j48_fsg_konosekainoitadakide
Paths That Will Never Cross	j49_fsg_majiwaranumichi
Floral Fury	rr15_chd_floralfury_rekkanogotoku
